44 44 44 44 44 44 44 44 44 44 44 44 44 44 44 44 44 44 44 44 44 44 44 44 44 44 44 44 44 44 44 44 44 44 44 44 44 44 44 44 44 44 44 44 44 44 44 44 44 44 44 44 44 44 44 44 44 44 44 44 44 44 44 44 44 44 44 44 44 44 44 44 44 44 44 44 44 44 44 44 44 44 44 44 44 44 44 44 44 44 44 44 44 44 44 44 44 44 44 44 
44 44 44 44 44 44 44 44 44 44 44 44 44 44 44 44 44 44 44 44 44 44 44 44 44 44 44 44 44 44 44 44 44 44 44 44 44 44 44 44 44 44 44 44 44 44 44 44 44 44 44 44 44 44 44 44 44 44 44 44 44 44 44 44 44 44 44 44 44 44 44 44 44 44 44 44 44 44 44 44 44 44 44 44 44 44 44 44 44 44 44 44 44 44 44 44 44 44 44 44 
44 44 44 44 44 44 44 44 44 44 44 44 44 44 44 44 44 44 44 44 44 44 44 44 44 44 44 44 44 44 44 44 44 44 44 44 44 44 44 44 44 44 44 44 44 44 44 44 44 44 44 44 44 44 44 44 44 44 44 44 44 44 44 44 44 44 44 44 44 44 44 44 44 44 44 44 44 44 44 44 44 44 44 44 44 44 44 44 44 44 44 44 44 44 44 44 44 44 44 44 
44 44 44 44 44 44 44 44 44 44 44 44 44 44 44 44 44 44 44 44 44 44 44 44 44 44 44 44 44 44 44 44 44 44 44 44 44 44 44 44 44 44 44 44 44 44 44 44 44 44 44 44 44 44 44 44 44 44 44 44 44 44 44 44 44 44 44 44 44 44 44 44 44 44 44 44 44 44 44 44 44 44 44 44 44 44 44 44 44 44 44 44 44 44 44 44 44 44 44 44 
44 44 44 44 44 44 44 44 44 44 44 44 44 44 44 44 44 44 44 44 44 44 44 44 44 44 44 44 44 44 44 44 44 44 44 44 44 44 44 44 44 44 44 44 44 44 44 44 44 44 44 44 44 44 44 44 44 44 44 44 44 44 44 44 44 44 44 44 44 44 44 44 44 44 44 44 44 44 44 44 44 44 44 44 44 44 44 44 44 44 44 44 44 44 44 44 44 44 44 44 
44 44 44 44 44 44 44 44 44 44 44 44 44 44 44 44 44 44 44 44 44 44 44 44 44 44 44 44 44 44 44 44 44 44 44 44 44 44 44 44 44 44 44 44 44 44 44 44 44 44 44 44 44 44 44 44 44 44 44 44 44 44 44 44 44 44 44 44 44 44 44 44 44 44 44 44 44 44 44 44 44 44 44 44 44 44 44 44 44 44 44 44 44 44 44 44 44 44 44 44 
44 44 44 44 44 44 44 44 44 44 44 44 44 44 44 44 44 44 44 44 44 44 44 44 44 44 44 44 44 44 44 44 44 44 44 44 44 44 44 44 44 44 44 44 44 44 44 44 44 44 44 44 44 44 44 44 44 44 44 44 44 44 44 44 44 44 44 44 44 44 44 44 44 44 44 44 44 44 44 44 44 44 44 44 44 44 44 44 44 44 44 44 44 44 44 44 44 44 44 44 
44 44 44 44 44 44 44 44 44 44 44 44 44 44 44 44 44 44 44 44 44 44 44 44 44 44 44 44 44 44 44 44 44 44 44 44 44 44 44 44 44 44 44 44 44 44 44 44 44 44 44 44 44 44 44 44 44 44 44 44 44 44 44 44 44 44 44 44 44 44 44 44 44 44 44 44 44 44 44 44 44 44 44 44 44 44 44 44 44 44 44 44 44 44 44 44 44 44 44 44 
44 44 44 44 44 44 44 44 44 44 44 44 44 44 44 44 44 44 44 44 44 44 44 44 44 44 44 44 44 44 44 44 44 44 44 44 44 44 44 44 44 44 44 44 44 44 44 44 44 44 44 44 44 44 44 44 44 44 44 44 44 44 44 44 44 44 44 44 44 44 44 44 44 44 44 44 44 44 44 44 44 44 44 44 44 44 44 44 44 44 44 44 44 44 44 44 44 44 44 44 
44 44 44 44 44 44 44 44 44 44 44 44 44 44 44 44 44 44 44 44 44 44 44 44 44 44 44 44 44 44 44 44 44 44 44 44 44 44 44 44 44 44 44 44 44 44 44 44 44 44 44 44 44 44 44 44 44 44 44 44 44 44 44 44 44 44 44 44 44 44 44 44 44 44 44 44 44 44 44 44 44 44 44 44 44 44 44 44 44 44 44 44 44 44 44 44 44 44 44 44 
44 44 44 44 44 44 44 44 44 44 44 44 44 44 44 44 44 44 44 44 44 44 44 44 44 44 44 44 44 44 44 44 44 44 44 44 44 44 44 44 44 44 44 44 44 44 44 44 44 44 44 44 44 44 44 44 44 44 44 44 44 44 44 44 44 44 44 44 44 44 44 44 44 44 44 44 44 44 44 44 44 44 44 44 44 44 44 44 44 44 44 44 44 44 44 44 44 44 44 44 
44 44 44 44 44 44 44 44 44 44 44 44 44 44 44 44 44 44 44 44 44 44 44 44 44 44 44 44 44 44 44 44 44 44 44 44 44 44 44 44 44 44 44 44 44 44 44 44 44 44 44 44 44 44 44 44 44 44 44 44 44 44 44 44 44 44 44 44 44 44 44 44 44 44 44 44 44 44 44 44 44 44 44 44 44 44 44 44 44 44 44 44 44 44 44 44 44 44 44 44 
44 44 44 44 44 44 44 44 44 44 44 44 44 44 44 44 44 44 44 44 44 44 44 44 44 44 44 44 44 44 44 44 44 44 44 44 44 44 44 44 44 44 44 44 44 44 44 44 44 44 44 44 44 44 44 44 44 44 44 44 44 44 44 44 44 44 44 44 44 44 44 44 44 44 44 44 44 44 44 44 44 44 44 44 44 44 44 44 44 44 44 44 44 44 44 44 44 44 44 44 
44 44 44 44 44 44 44 44 44 44 44 44 44 44 44 44 44 44 44 44 44 44 44 44 44 44 44 44 44 44 44 44 44 44 44 44 44 44 44 44 44 44 44 44 44 44 44 44 44 44 44 44 44 44 44 44 44 44 44 44 44 44 44 44 44 44 44 44 44 44 44 44 44 44 44 44 44 44 44 44 44 44 44 44 44 44 44 44 44 44 44 44 44 44 44 44 44 44 44 44 
44 44 44 44 44 44 44 44 44 44 44 44 44 44 44 44 44 44 44 44 44 44 44 44 44 44 44 44 44 44 44 44 44 44 44 44 44 44 44 44 44 44 44 44 44 44 44 44 44 44 44 44 44 44 44 44 44 44 44 44 44 44 44 44 44 44 44 44 44 44 44 44 44 44 44 44 44 44 44 44 44 44 44 44 44 44 44 44 44 44 44 44 44 44 44 44 44 44 44 44 
44 44 44 44 44 44 44 44 44 44 44 44 44 44 44 44 44 44 44 44 44 44 44 44 44 44 44 44 44 44 44 44 44 44 44 44 44 44 44 44 44 44 44 44 44 44 44 44 44 44 44 44 44 44 44 44 44 44 44 44 44 44 44 44 44 44 44 44 44 44 44 44 44 44 44 44 44 44 44 44 44 44 44 44 44 44 44 44 44 44 44 44 44 44 44 44 44 44 44 44 
44 44 44 44 44 44 44 44 44 44 44 44 44 44 44 44 5 5 5 5 5 5 5 5 5 5 5 5 5 5 5 5 5 5 5 5 5 5 5 5 5 5 5 5 5 5 5 5 5 5 5 5 5 5 5 5 5 5 5 5 5 5 5 5 5 5 5 5 5 5 5 44 44 44 44 44 44 44 44 44 44 44 44 44 44 44 44 44 44 44 44 44 44 44 44 44 44 44 44 44 
44 44 44 44 44 44 44 44 44 44 44 44 44 44 44 5 5 5 5 5 5 5 5 5 5 5 5 5 5 5 5 5 5 5 5 5 5 5 5 5 5 5 5 5 5 5 5 5 5 5 5 5 5 5 5 5 5 5 5 5 5 5 5 5 5 5 5 5 5 5 5 5 5 5 44 44 44 44 44 44 44 44 44 44 44 44 44 44 44 44 44 44 44 44 44 44 44 44 44 44 
44 44 44 44 44 44 44 44 44 44 44 44 44 44 44 5 5 5 5 5 5 5 5 5 5 5 5 5 5 5 5 5 5 5 5 5 5 5 5 5 5 5 5 5 5 5 5 5 5 5 5 5 5 5 5 5 5 5 41 41 41 5 5 5 5 5 5 5 5 5 5 5 5 5 5 5 5 44 44 44 44 44 44 44 44 44 44 44 44 44 44 44 44 44 44 44 44 44 44 44 
44 44 44 44 44 44 44 44 44 44 44 44 44 44 44 5 5 5 5 5 5 5 5 5 5 5 5 5 5 5 5 5 5 5 5 5 5 5 5 5 5 5 5 5 5 5 5 5 5 5 5 5 5 5 5 5 5 41 5 5 41 41 41 5 5 41 41 41 41 41 5 5 5 5 5 5 5 5 5 44 44 44 44 44 44 44 44 44 44 44 44 44 44 44 44 44 44 44 44 44 
44 44 44 44 44 44 44 44 44 44 44 44 44 44 5 5 5 5 5 5 5 5 5 5 5 5 41 41 41 41 41 41 41 5 5 5 5 5 5 5 5 5 5 5 5 5 5 5 5 5 5 5 5 5 5 5 41 41 5 5 5 5 41 41 41 41 5 5 5 41 41 5 5 5 5 5 5 5 5 5 44 44 44 44 44 44 44 44 44 44 44 44 44 44 44 44 44 44 44 44 
44 44 44 44 44 44 44 44 44 44 44 44 44 5 5 5 5 5 5 5 5 5 5 41 41 41 5 5 41 5 5 5 5 41 41 41 41 5 5 5 5 5 5 5 5 5 5 5 5 5 5 5 5 5 5 5 41 5 5 5 5 5 5 5 5 5 5 5 5 5 41 41 41 5 5 5 5 5 5 5 44 44 44 44 44 44 44 44 44 44 44 44 44 44 44 44 44 44 44 44 
44 44 44 44 44 44 44 44 44 44 44 44 44 5 5 5 5 5 5 5 5 5 5 41 5 5 5 5 5 5 5 5 5 5 5 5 41 41 5 5 5 5 5 5 5 5 5 5 5 5 5 5 5 5 5 5 41 41 41 41 41 41 41 5 5 5 5 5 5 5 5 5 41 41 5 5 5 5 5 5 44 44 44 44 44 44 44 44 44 44 44 44 44 44 44 44 44 44 44 44 
44 44 44 44 44 44 44 44 44 44 44 44 5 5 5 5 41 5 5 5 5 5 41 5 5 5 5 5 5 5 5 5 5 5 5 5 5 5 41 41 5 5 5 5 5 5 5 5 5 5 5 5 5 5 41 41 5 5 5 5 5 5 41 41 41 5 5 5 5 5 5 5 5 5 41 41 5 5 5 5 44 44 44 44 44 44 44 44 44 44 44 44 44 44 44 44 44 44 44 44 
44 44 44 44 44 44 44 44 44 44 44 44 5 5 5 5 41 41 5 5 5 5 41 5 5 5 5 5 41 5 5 5 5 5 5 5 5 5 5 41 41 41 5 5 5 5 5 5 5 5 5 5 5 41 41 5 5 5 5 5 5 5 5 5 5 41 41 5 5 5 5 5 5 5 5 5 41 5 5 5 44 44 44 44 44 44 44 44 44 44 44 44 44 44 44 44 44 44 44 44 
44 44 44 44 44 44 44 44 44 44 44 44 5 5 5 5 5 41 5 5 5 41 41 5 5 5 5 41 5 5 5 5 5 5 5 5 5 5 5 5 5 41 41 41 41 5 5 5 5 5 5 41 41 5 5 5 5 5 5 5 5 5 5 5 5 5 5 41 41 41 5 5 5 5 41 41 5 5 5 44 44 44 44 44 44 44 44 44 44 44 44 44 44 44 44 44 44 44 44 44 
44 44 44 44 44 44 44 44 44 44 44 44 5 5 5 5 5 5 41 41 41 41 5 5 5 5 5 5 5 5 5 5 5 5 5 5 5 5 5 5 5 5 5 5 41 41 41 41 5 41 41 41 5 5 5 5 5 5 5 5 5 5 5 5 5 5 5 5 5 41 41 5 5 41 41 5 5 5 5 44 44 44 44 44 44 44 44 44 44 44 44 44 44 44 44 44 44 44 44 44 
44 44 44 44 44 44 44 44 44 44 44 44 5 5 5 5 5 5 5 5 5 5 5 5 5 5 41 5 5 5 5 5 5 5 5 5 5 5 5 5 5 5 5 5 5 5 5 41 41 41 5 5 5 5 5 5 5 5 5 5 5 5 5 5 5 5 5 5 5 5 5 41 5 41 5 5 5 5 5 44 44 44 44 44 44 44 44 44 44 44 44 44 44 44 44 44 44 44 44 44 
44 44 44 44 44 44 44 44 44 44 44 44 5 5 5 5 5 5 5 5 5 5 5 5 5 41 41 5 5 5 5 5 5 5 5 5 5 5 5 5 5 5 5 5 5 5 5 5 19 19 5 5 5 5 5 5 5 5 5 5 5 5 5 5 5 5 5 5 5 5 5 5 5 41 5 5 5 5 5 44 44 44 44 44 44 44 44 44 44 44 44 44 44 44 44 44 44 44 44 44 
44 44 44 44 44 44 44 44 44 44 44 44 5 5 5 5 5 5 5 5 5 5 5 5 5 41 5 5 5 5 5 28 26 26 26 26 26 26 26 26 26 26 26 26 26 26 26 27 19 19 25 26 26 26 26 26 26 26 26 26 26 26 26 26 26 26 26 29 5 5 5 5 5 41 41 5 5 5 5 44 44 44 44 44 44 44 44 44 44 44 44 44 44 44 44 44 44 44 44 44 
44 44 44 44 44 44 44 44 44 44 44 44 5 5 5 5 41 5 5 5 5 5 5 5 41 5 5 5 5 5 5 24 2 19 19 19 19 19 19 19 19 19 19 19 19 19 19 19 19 19 19 19 19 19 19 19 19 19 19 19 19 19 2 19 19 19 19 23 5 5 5 5 5 41 5 5 5 5 5 44 44 44 44 44 44 44 44 44 44 44 44 44 44 44 44 44 44 44 44 44 
44 44 44 44 44 44 44 44 44 44 44 5 5 5 5 5 41 5 5 5 5 5 5 5 41 5 5 5 5 5 5 24 19 19 19 19 19 19 19 19 2 19 19 19 19 19 19 19 19 19 19 19 19 19 19 19 19 19 19 2 19 19 19 19 19 19 19 23 5 5 5 5 5 41 41 5 5 5 5 44 44 44 44 44 44 44 44 44 44 44 44 44 44 44 44 44 44 44 44 44 
44 44 44 44 44 44 44 44 44 44 5 5 5 5 5 5 5 41 41 41 41 41 41 41 41 41 5 5 5 5 5 24 19 19 20 21 21 21 21 22 19 20 21 21 21 21 21 22 19 19 20 22 19 20 21 21 21 21 21 21 21 21 21 21 22 19 19 23 5 5 5 5 5 5 41 5 5 5 5 44 44 44 44 44 44 44 44 44 44 44 44 44 44 44 44 44 44 44 44 44 
44 44 44 44 44 44 44 44 44 44 5 5 5 5 5 5 5 5 41 5 5 5 5 41 5 41 41 5 5 5 5 24 19 19 23 6 6 6 6 24 19 23 6 6 6 6 6 24 19 2 23 24 19 23 6 6 6 6 26 26 26 26 26 29 24 19 19 23 5 5 5 5 5 5 41 41 5 5 5 44 44 44 44 44 44 44 44 44 44 44 44 44 44 44 44 44 44 44 44 44 
44 44 44 44 44 44 44 44 44 5 5 5 5 5 5 5 5 5 41 41 5 5 41 5 5 5 41 41 5 5 5 24 19 19 23 6 6 6 6 24 19 23 6 6 6 6 6 24 19 19 23 24 19 23 6 6 26 27 19 19 19 19 19 23 24 19 19 23 5 5 5 5 5 5 5 41 5 5 5 44 44 44 44 44 44 44 44 44 44 44 44 44 44 44 44 44 44 44 44 44 
44 44 44 44 44 44 44 44 44 5 5 5 5 5 5 5 5 5 5 41 5 5 5 5 5 5 5 41 5 5 5 24 19 19 23 6 6 6 28 27 19 26 26 26 26 29 6 24 19 19 23 24 19 23 6 24 19 19 19 19 20 22 19 23 24 19 19 23 5 5 6 5 5 5 5 41 41 5 5 44 44 44 44 44 44 44 44 44 44 44 44 44 44 44 44 44 44 44 44 44 
44 44 44 44 44 44 44 44 5 5 5 5 5 5 5 5 5 5 5 41 41 41 5 5 5 5 5 41 5 5 5 24 19 19 23 6 26 26 27 19 19 19 19 19 19 25 29 24 19 19 23 24 19 23 6 30 21 22 19 20 6 24 19 23 24 19 19 23 5 5 5 5 5 5 5 5 41 41 5 44 44 44 44 44 44 44 44 44 44 44 44 44 44 44 44 44 44 44 44 44 
44 44 44 44 44 44 44 44 5 5 5 5 5 5 5 5 5 5 5 5 41 41 5 5 5 5 5 41 5 5 5 24 19 19 23 24 19 19 19 19 19 20 21 22 19 19 23 24 19 19 23 24 19 23 6 6 6 24 19 25 26 27 19 25 24 19 2 23 5 5 5 5 5 5 5 5 5 41 5 5 44 44 44 44 44 44 44 44 44 44 44 44 44 44 44 44 44 44 44 44 
44 44 44 44 44 44 44 44 5 5 5 5 5 5 5 5 5 5 5 41 5 41 41 5 5 5 5 41 5 5 5 24 19 19 25 27 19 19 20 22 19 25 6 6 21 21 6 24 19 19 23 24 19 19 19 19 19 19 19 19 19 19 19 19 24 19 19 23 5 5 5 6 6 41 41 41 5 41 5 5 44 44 44 44 44 44 44 44 44 44 44 44 44 44 44 44 44 44 44 44 
44 44 44 44 44 44 44 44 44 5 5 5 5 5 5 5 5 5 41 41 5 5 41 41 5 5 5 41 5 5 5 24 19 19 19 19 19 19 23 24 19 19 25 26 26 29 6 24 19 19 23 6 21 21 21 21 21 22 19 20 21 21 21 21 24 19 19 23 5 5 5 5 5 6 6 41 41 41 5 5 44 44 44 44 44 44 44 44 44 44 44 44 44 44 44 44 44 44 44 44 
44 44 44 44 44 44 44 44 44 5 5 5 5 5 5 5 5 41 41 41 5 5 5 41 41 5 41 5 5 5 5 24 19 19 20 21 21 21 31 24 19 20 19 19 19 23 6 24 19 19 23 6 6 6 5 5 6 24 19 23 6 6 6 6 24 19 19 23 5 5 5 5 5 41 6 5 41 5 5 5 44 44 44 44 44 44 44 44 44 44 44 44 44 44 44 44 44 44 44 44 
44 44 44 44 44 44 44 44 44 5 5 5 5 5 5 5 5 41 5 41 41 5 5 5 41 41 5 41 41 5 5 24 19 19 23 6 6 6 6 24 19 23 21 22 19 23 6 27 19 19 25 6 6 6 5 5 6 24 19 23 6 6 6 6 24 19 19 23 5 5 5 5 5 41 6 6 41 5 5 5 44 44 44 44 44 44 44 44 44 44 44 44 44 44 44 44 44 44 44 44 
44 44 44 44 44 44 44 44 44 5 5 5 5 5 5 5 5 41 5 5 41 5 5 5 5 5 5 5 41 41 5 24 19 19 23 6 6 6 6 24 19 23 6 24 19 23 24 2 19 19 19 23 5 5 5 6 6 24 19 23 6 6 6 6 24 19 19 23 5 5 5 6 5 41 5 6 41 5 5 5 44 44 44 44 44 44 44 44 44 44 44 44 44 44 44 44 44 44 44 44 
44 44 44 44 44 44 44 44 44 44 5 5 5 5 5 5 5 41 5 5 5 5 5 5 5 5 5 5 5 41 5 6 19 19 25 26 26 26 26 26 26 26 26 27 19 25 27 19 19 19 19 25 26 26 26 26 26 27 19 25 26 26 26 26 27 19 19 6 6 5 5 5 5 41 5 6 41 41 5 5 5 5 5 44 44 44 44 44 44 44 44 44 44 44 44 44 44 44 44 44 
44 44 44 44 44 44 44 44 44 44 5 5 5 5 5 5 5 41 5 5 5 5 41 5 5 5 5 5 5 41 41 41 2 19 19 19 19 19 19 19 19 19 19 19 19 19 19 19 19 19 19 19 19 19 19 19 19 19 19 19 19 19 19 19 2 19 19 41 41 5 5 5 41 5 5 5 6 41 5 5 5 5 5 5 44 44 44 44 44 44 44 44 44 44 44 44 44 44 44 44 
44 44 44 44 44 44 44 44 44 44 44 5 5 5 5 5 5 5 5 5 5 5 5 41 5 5 5 5 5 41 41 41 19 19 19 19 19 19 19 19 19 19 19 19 19 19 19 19 19 19 19 19 19 19 19 19 19 19 19 19 19 19 19 19 19 19 19 41 41 5 5 5 41 5 5 5 6 41 5 5 5 5 5 5 5 5 44 44 44 44 44 44 44 44 44 44 44 44 44 44 
44 44 44 44 44 44 44 44 44 44 44 44 5 5 5 5 5 5 41 5 5 5 5 41 41 5 5 5 5 41 5 6 19 19 20 21 21 21 21 22 19 20 21 21 21 21 22 19 19 19 19 20 21 21 21 21 21 22 19 20 21 21 21 21 22 19 19 6 6 5 5 41 41 5 5 5 6 41 41 5 5 5 5 5 5 5 44 44 44 44 44 44 44 44 44 44 44 44 44 44 
44 44 44 44 44 44 44 44 44 44 44 44 44 5 5 5 5 5 41 5 5 5 5 5 41 41 41 5 5 5 5 24 19 19 25 26 26 26 26 24 19 23 6 6 6 6 24 19 19 19 2 23 6 6 6 6 6 24 19 23 6 6 6 6 24 19 19 23 6 5 5 41 5 5 5 5 6 6 41 5 5 5 5 5 5 5 44 44 44 44 44 44 44 44 44 44 44 44 44 44 
44 44 44 44 44 44 44 44 44 44 44 44 44 44 5 5 5 5 5 41 5 5 5 5 5 5 41 41 5 5 5 24 19 19 19 19 19 19 19 24 19 23 6 6 6 6 30 22 19 19 20 31 6 6 26 26 26 27 19 23 6 6 6 6 24 19 19 23 5 5 5 41 5 5 5 5 41 41 41 41 5 5 5 5 5 5 44 44 44 44 44 44 44 44 44 44 44 44 44 44 
44 44 44 44 44 44 44 44 44 44 44 44 44 44 44 5 5 5 5 41 41 5 5 5 5 5 5 41 41 5 5 24 19 19 23 21 21 22 19 24 19 23 6 6 6 6 6 24 19 19 23 6 6 24 19 19 19 19 19 23 6 6 6 6 24 19 19 23 5 5 41 5 5 5 5 5 5 41 41 5 5 5 5 5 5 5 44 44 44 44 44 44 44 44 44 44 44 44 44 44 
44 44 44 44 44 44 44 44 44 44 44 44 44 44 44 44 5 5 5 5 41 41 5 5 5 5 5 5 41 5 5 24 19 19 23 24 19 19 19 24 19 23 26 26 26 26 26 27 19 19 25 26 26 24 19 20 21 21 21 31 6 6 6 6 24 19 19 23 5 5 5 5 5 5 5 5 5 5 41 41 41 5 5 5 5 44 44 44 44 44 44 44 44 44 44 44 44 44 44 44 
44 44 44 44 44 44 44 44 44 44 44 44 44 44 44 44 5 5 5 5 5 41 5 5 5 5 5 5 41 5 5 24 19 19 23 24 19 20 6 27 19 25 19 19 19 19 19 19 19 19 19 19 19 24 19 25 26 26 26 26 26 26 26 29 24 19 19 23 5 5 5 5 5 5 5 5 5 5 5 5 41 41 5 5 5 44 44 44 44 44 44 44 44 44 44 44 44 44 44 44 
44 44 44 44 44 44 44 44 44 44 44 44 44 44 44 5 5 5 5 5 5 5 41 5 5 5 5 41 41 5 5 24 19 19 23 24 19 19 23 19 19 19 20 21 21 21 21 22 19 19 20 21 21 24 19 19 19 19 19 19 19 19 19 23 24 19 19 23 5 5 5 5 5 5 5 5 5 5 5 5 5 41 5 5 5 44 44 44 44 44 44 44 44 44 44 44 44 44 44 44 
44 44 44 44 44 44 44 44 44 44 44 44 5 5 5 5 5 5 5 5 5 5 41 5 5 5 5 41 5 5 5 24 19 19 23 6 22 19 23 19 20 19 19 23 6 6 6 24 19 19 23 6 6 30 21 21 21 21 21 21 21 22 19 23 24 19 19 23 5 5 5 5 5 41 41 41 5 5 5 5 41 41 5 5 5 44 44 44 44 44 44 44 44 44 44 44 44 44 44 44 
44 44 44 44 44 44 44 44 44 44 5 5 5 5 5 5 5 5 5 5 5 5 41 5 5 5 5 41 5 5 5 24 19 19 23 6 27 19 23 19 23 19 20 6 6 6 6 24 19 19 23 6 6 6 6 6 6 6 6 6 6 24 19 23 24 19 19 23 5 5 5 5 41 41 5 41 41 41 5 41 41 5 5 5 5 44 44 44 44 44 44 44 44 44 44 44 44 44 44 44 
44 44 44 44 44 44 44 44 44 5 5 5 5 5 5 5 5 5 5 5 5 5 41 5 5 5 41 41 5 5 5 24 19 19 23 24 19 19 23 19 23 19 25 26 26 29 6 24 19 19 23 6 6 6 6 6 6 6 6 6 6 24 19 23 24 19 19 23 5 5 5 41 41 5 5 5 5 41 41 41 5 5 5 5 5 44 44 44 44 44 44 44 44 44 44 44 44 44 44 44 
44 44 44 44 44 44 44 44 44 5 5 5 5 5 5 5 5 5 5 5 5 5 41 5 5 5 41 5 5 5 5 24 19 2 23 24 19 20 6 19 23 19 19 19 19 25 26 27 19 19 23 6 6 6 6 6 6 6 5 6 6 24 19 23 24 19 19 23 5 5 5 5 41 41 5 5 5 5 5 5 5 5 5 5 44 44 44 44 44 44 44 44 44 44 44 44 44 44 44 44 
44 44 44 44 44 44 44 44 44 5 5 5 5 5 5 5 5 5 5 41 41 41 41 5 5 5 41 5 5 5 5 24 19 19 23 24 19 19 19 19 31 21 21 22 19 19 19 19 19 19 23 28 26 26 26 26 26 26 26 26 26 27 19 25 27 19 19 23 5 5 5 5 5 41 41 5 5 5 5 5 5 5 5 44 44 44 44 44 44 44 44 44 44 44 44 44 44 44 44 44 
44 44 44 44 44 44 44 44 44 5 5 5 5 5 5 5 5 5 5 5 5 5 5 5 5 5 41 41 5 5 5 24 19 19 23 6 21 21 21 21 6 6 6 6 21 21 21 22 19 19 23 24 19 19 19 19 19 19 19 19 19 19 19 19 19 19 2 23 5 5 5 5 5 5 41 5 5 5 5 5 5 5 5 44 44 44 44 44 44 44 44 44 44 44 44 44 44 44 44 44 
44 44 44 44 44 44 44 44 44 5 5 5 5 5 5 5 5 5 5 41 41 41 41 5 5 5 5 41 5 5 5 24 19 19 23 6 6 6 6 6 6 6 6 6 6 6 6 24 19 19 23 30 21 21 21 21 21 21 21 21 21 22 19 20 22 19 19 23 5 5 5 5 5 5 41 5 5 5 5 5 5 5 44 44 44 44 44 44 44 44 44 44 44 44 44 44 44 44 44 44 
44 44 44 44 44 44 44 44 44 5 5 5 5 5 5 5 5 5 41 41 5 5 41 41 5 5 5 41 41 5 5 24 19 19 25 26 26 26 26 26 26 26 26 26 26 26 26 27 19 19 25 26 26 26 26 26 26 26 26 26 26 26 26 26 27 19 19 23 5 5 5 5 5 5 41 5 5 5 5 5 5 5 44 44 44 44 44 44 44 44 44 44 44 44 44 44 44 44 44 44 
44 44 44 44 44 44 44 44 44 5 5 5 5 5 5 5 5 5 41 5 5 5 5 41 5 5 5 5 41 41 5 24 19 19 19 19 19 19 19 19 19 19 19 19 19 19 2 19 19 19 19 19 19 19 19 19 19 19 19 19 19 19 19 19 19 19 19 23 5 5 5 5 5 41 41 5 5 5 5 5 5 5 44 44 44 44 44 44 44 44 44 44 44 44 44 44 44 44 44 44 
44 44 44 44 44 44 44 44 44 44 5 5 5 5 5 5 5 5 41 41 5 5 5 5 5 41 5 41 41 41 5 24 19 19 19 19 19 19 19 19 19 2 19 19 19 19 19 19 19 19 19 19 19 19 19 19 19 19 2 19 19 19 19 19 19 19 19 23 5 5 5 5 41 41 5 5 5 5 5 5 5 44 44 44 44 44 44 44 44 44 44 44 44 44 44 44 44 44 44 44 
44 44 44 44 44 44 44 44 44 44 44 44 5 5 5 5 5 5 5 41 41 5 5 5 5 41 41 5 5 5 5 30 21 21 21 21 21 21 21 21 21 21 21 21 21 21 21 22 19 19 20 21 21 21 21 21 21 21 21 21 21 21 21 21 21 21 21 31 5 5 5 5 41 5 5 5 5 5 5 5 5 44 44 44 44 44 44 44 44 44 44 44 44 44 44 44 44 44 44 44 
44 44 44 44 44 44 44 44 44 44 44 44 44 44 44 44 44 5 5 5 41 5 5 5 5 5 41 41 5 5 5 5 5 5 5 5 5 5 5 5 5 5 5 5 5 5 5 5 19 19 5 5 5 5 5 5 5 5 5 5 5 5 5 5 5 5 5 5 5 5 5 41 5 5 5 5 5 5 5 5 5 44 44 44 44 44 44 44 44 44 44 44 44 44 44 44 44 44 44 44 
44 44 44 44 44 44 44 44 44 44 44 44 44 44 44 44 44 44 44 5 41 41 5 5 5 5 5 41 5 5 5 5 5 5 5 5 5 5 5 5 5 5 5 5 5 5 5 5 5 5 5 5 5 5 5 5 5 5 5 5 41 41 41 41 41 41 41 5 5 5 5 41 5 5 5 5 5 5 5 5 44 44 44 44 44 44 44 44 44 44 44 44 44 44 44 44 44 44 44 44 
44 44 44 44 44 44 44 44 44 44 44 44 44 44 44 44 44 44 44 44 5 41 5 5 5 5 5 41 41 41 41 41 41 41 5 5 5 5 5 5 5 5 5 5 5 5 5 5 5 41 41 41 41 41 41 41 41 41 41 41 41 41 41 41 41 41 5 41 41 5 41 41 5 5 5 5 5 5 5 44 44 44 44 44 44 44 44 44 44 44 44 44 44 44 44 44 44 44 44 44 
44 44 44 44 44 44 44 44 44 44 44 44 44 44 44 44 44 44 44 44 44 5 41 41 5 5 41 41 41 41 41 41 41 41 41 5 5 5 5 5 5 5 5 5 5 41 41 41 41 41 41 41 41 41 41 41 41 41 41 41 41 41 41 41 41 41 41 41 41 5 41 5 5 5 5 5 5 5 5 44 44 44 44 44 44 44 44 44 44 44 44 44 44 44 44 44 44 44 44 44 
44 44 44 44 44 44 44 44 44 44 44 44 44 44 44 44 44 44 44 44 44 44 5 5 41 41 41 41 41 41 41 41 41 41 41 41 5 5 41 41 41 41 41 41 41 41 41 41 41 41 41 41 41 41 41 41 41 41 41 41 41 41 41 41 41 41 41 41 5 5 41 5 5 5 5 5 5 5 44 44 44 44 44 44 44 44 44 44 44 44 44 44 44 44 44 44 44 44 44 44 
44 44 44 44 44 44 44 44 44 44 44 44 44 44 44 44 44 44 44 44 44 44 44 5 5 5 5 5 41 41 41 41 41 41 41 41 41 41 41 41 41 41 41 41 41 41 41 41 41 41 5 5 5 5 41 41 41 41 41 41 41 41 41 41 41 41 41 41 41 41 5 5 5 5 5 5 5 5 44 44 44 44 44 44 44 44 44 44 44 44 44 44 44 44 44 44 44 44 44 44 
44 44 44 44 44 44 44 44 44 44 44 44 44 44 44 44 44 44 44 44 44 44 44 44 5 5 5 5 5 41 41 41 41 41 41 41 41 41 41 41 41 41 41 41 41 41 41 41 5 5 5 5 5 5 5 5 41 41 41 41 41 41 41 41 41 41 5 41 41 41 5 5 5 5 5 5 5 5 44 44 44 44 44 44 44 44 44 44 44 44 44 44 44 44 44 44 44 44 44 44 
44 44 44 44 44 44 44 44 44 44 44 44 44 44 44 44 44 44 44 44 44 44 44 44 44 5 5 5 5 5 41 41 41 41 41 41 41 41 41 41 41 41 5 41 41 41 41 5 5 5 5 5 5 5 5 5 5 5 41 41 41 41 41 41 41 41 5 41 41 5 5 5 5 5 5 5 5 44 44 44 44 44 44 44 44 44 44 44 44 44 44 44 44 44 44 44 44 44 44 44 
44 44 44 44 44 44 44 44 44 44 44 44 44 44 44 44 44 44 44 44 44 44 44 44 44 44 5 5 5 5 5 5 41 41 41 41 41 41 41 41 41 41 41 41 41 41 5 5 5 5 5 5 5 5 5 5 5 5 5 5 5 5 5 5 5 41 41 41 5 5 5 5 5 5 5 5 5 44 44 44 44 44 44 44 44 44 44 44 44 44 44 44 44 44 44 44 44 44 44 44 
44 44 44 44 44 44 44 44 44 44 44 44 44 44 44 44 44 44 44 44 44 44 44 44 44 44 5 5 5 5 5 5 5 5 41 41 41 5 5 41 41 41 41 41 41 5 41 41 5 5 5 5 5 5 5 5 5 5 5 5 5 5 5 41 41 41 5 5 5 5 5 5 5 5 5 5 44 44 44 44 44 44 44 44 44 44 44 44 44 44 44 44 44 44 44 44 44 44 44 44 
44 44 44 44 44 44 44 44 44 44 44 44 44 44 44 44 44 44 44 44 44 44 44 44 44 44 44 44 5 5 5 5 5 5 5 5 41 41 41 5 5 5 5 5 5 5 5 41 41 41 41 41 41 5 41 5 5 5 5 41 41 41 41 41 5 5 5 5 5 5 5 5 5 5 5 44 44 44 44 44 44 44 44 44 44 44 44 44 44 44 44 44 44 44 44 44 44 44 44 44 
44 44 44 44 44 44 44 44 44 44 44 44 44 44 44 44 44 44 44 44 44 44 44 44 44 44 44 44 44 44 44 5 5 5 5 5 5 5 41 41 41 5 5 5 5 5 5 5 5 5 5 5 5 5 41 5 41 41 41 5 5 5 5 5 5 5 5 5 5 5 5 5 5 5 44 44 44 44 44 44 44 44 44 44 44 44 44 44 44 44 44 44 44 44 44 44 44 44 44 44 
44 44 44 44 44 44 44 44 44 44 44 44 44 44 44 44 44 44 44 44 44 44 44 44 44 44 44 44 44 44 44 44 44 44 5 5 5 5 5 5 41 41 41 5 5 5 5 5 5 5 5 5 5 5 5 5 5 5 5 5 5 5 5 5 5 5 5 5 5 5 5 44 44 44 44 44 44 44 44 44 44 44 44 44 44 44 44 44 44 44 44 44 44 44 44 44 44 44 44 44 
44 44 44 44 44 44 44 44 44 44 44 44 44 44 44 44 44 44 44 44 44 44 44 44 44 44 44 44 44 44 44 44 44 44 44 44 44 5 5 5 5 5 5 5 5 5 5 5 5 5 5 44 44 44 44 44 5 5 5 5 5 5 5 5 5 5 44 44 44 44 44 44 44 44 44 44 44 44 44 44 44 44 44 44 44 44 44 44 44 44 44 44 44 44 44 44 44 44 44 44 
44 44 44 44 44 44 44 44 44 44 44 44 44 44 44 44 44 44 44 44 44 44 44 44 44 44 44 44 44 44 44 44 44 44 44 44 44 44 44 44 44 44 44 44 44 44 44 44 44 44 44 44 44 44 44 44 44 44 44 44 44 44 44 44 44 44 44 44 44 44 44 44 44 44 44 44 44 44 44 44 44 44 44 44 44 44 44 44 44 44 44 44 44 44 44 44 44 44 44 44 
44 44 44 44 44 44 44 44 44 44 44 44 44 44 44 44 44 44 44 44 44 44 44 44 44 44 44 44 44 44 44 44 44 44 44 44 44 44 44 44 44 44 44 44 44 44 44 44 44 44 44 44 44 44 44 44 44 44 44 44 44 44 44 44 44 44 44 44 44 44 44 44 44 44 44 44 44 44 44 44 44 44 44 44 44 44 44 44 44 44 44 44 44 44 44 44 44 44 44 44 
44 44 44 44 44 44 44 44 44 44 44 44 44 44 44 44 44 44 44 44 44 44 44 44 44 44 44 44 44 44 44 44 44 44 44 44 44 44 44 44 44 44 44 44 44 44 44 44 44 44 44 44 44 44 44 44 44 44 44 44 44 44 44 44 44 44 44 44 44 44 44 44 44 44 44 44 44 44 44 44 44 44 44 44 44 44 44 44 44 44 44 44 44 44 44 44 44 44 44 44 
44 44 44 44 44 44 44 44 44 44 44 44 44 44 44 44 44 44 44 44 44 44 44 44 44 44 44 44 44 44 44 44 44 44 44 44 44 44 44 44 44 44 44 44 44 44 44 44 44 44 44 44 44 44 44 44 44 44 44 44 44 44 44 44 44 44 44 44 44 44 44 44 44 44 44 44 44 44 44 44 44 44 44 44 44 44 44 44 44 44 44 44 44 44 44 44 44 44 44 44 
44 44 44 44 44 44 44 44 44 44 44 44 44 44 44 44 44 44 44 44 44 44 44 44 44 44 44 44 44 44 44 44 44 44 44 44 44 44 44 44 44 44 44 44 44 44 44 44 44 44 44 44 44 44 44 44 44 44 44 44 44 44 44 44 44 44 44 44 44 44 44 44 44 44 44 44 44 44 44 44 44 44 44 44 44 44 44 44 44 44 44 44 44 44 44 44 44 44 44 44 
44 44 44 44 44 44 44 44 44 44 44 44 44 44 44 44 44 44 44 44 44 44 44 44 44 44 44 44 44 44 44 44 44 44 44 44 44 44 44 44 44 44 44 44 44 44 44 44 44 44 44 44 44 44 44 44 44 44 44 44 44 44 44 44 44 44 44 44 44 44 44 44 44 44 44 44 44 44 44 44 44 44 44 44 44 44 44 44 44 44 44 44 44 44 44 44 44 44 44 44 
44 44 44 44 44 44 44 44 44 44 44 44 44 44 44 44 44 44 44 44 44 44 44 44 44 44 44 44 44 44 44 44 44 44 44 44 44 44 44 44 44 44 44 44 44 44 44 44 44 44 44 44 44 44 44 44 44 44 44 44 44 44 44 44 44 44 44 44 44 44 44 44 44 44 44 44 44 44 44 44 44 44 44 44 44 44 44 44 44 44 44 44 44 44 44 44 44 44 44 44 
44 44 44 44 44 44 44 44 44 44 44 44 44 44 44 44 44 44 44 44 44 44 44 44 44 44 44 44 44 44 44 44 44 44 44 44 44 44 44 44 44 44 44 44 44 44 44 44 44 44 44 44 44 44 44 44 44 44 44 44 44 44 44 44 44 44 44 44 44 44 44 44 44 44 44 44 44 44 44 44 44 44 44 44 44 44 44 44 44 44 44 44 44 44 44 44 44 44 44 44 
44 44 44 44 44 44 44 44 44 44 44 44 44 44 44 44 44 44 44 44 44 44 44 44 44 44 44 44 44 44 44 44 44 44 44 44 44 44 44 44 44 44 44 44 44 44 44 44 44 44 44 44 44 44 44 44 44 44 44 44 44 44 44 44 44 44 44 44 44 44 44 44 44 44 44 44 44 44 44 44 44 44 44 44 44 44 44 44 44 44 44 44 44 44 44 44 44 44 44 44 
44 44 44 44 44 44 44 44 44 44 44 44 44 44 44 44 44 44 44 44 44 44 44 44 44 44 44 44 44 44 44 44 44 44 44 44 44 44 44 44 44 44 44 44 44 44 44 44 44 44 44 44 44 44 44 44 44 44 44 44 44 44 44 44 44 44 44 44 44 44 44 44 44 44 44 44 44 44 44 44 44 44 44 44 44 44 44 44 44 44 44 44 44 44 44 44 44 44 44 44 
44 44 44 44 44 44 44 44 44 44 44 44 44 44 44 44 44 44 44 44 44 44 44 44 44 44 44 44 44 44 44 44 44 44 44 44 44 44 44 44 44 44 44 44 44 44 44 44 44 44 44 44 44 44 44 44 44 44 44 44 44 44 44 44 44 44 44 44 44 44 44 44 44 44 44 44 44 44 44 44 44 44 44 44 44 44 44 44 44 44 44 44 44 44 44 44 44 44 44 44 
44 44 44 44 44 44 44 44 44 44 44 44 44 44 44 44 44 44 44 44 44 44 44 44 44 44 44 44 44 44 44 44 44 44 44 44 44 44 44 44 44 44 44 44 44 44 44 44 44 44 44 44 44 44 44 44 44 44 44 44 44 44 44 44 44 44 44 44 44 44 44 44 44 44 44 44 44 44 44 44 44 44 44 44 44 44 44 44 44 44 44 44 44 44 44 44 44 44 44 44 
44 44 44 44 44 44 44 44 44 44 44 44 44 44 44 44 44 44 44 44 44 44 44 44 44 44 44 44 44 44 44 44 44 44 44 44 44 44 44 44 44 44 44 44 44 44 44 44 44 44 44 44 44 44 44 44 44 44 44 44 44 44 44 44 44 44 44 44 44 44 44 44 44 44 44 44 44 44 44 44 44 44 44 44 44 44 44 44 44 44 44 44 44 44 44 44 44 44 44 44 
44 44 44 44 44 44 44 44 44 44 44 44 44 44 44 44 44 44 44 44 44 44 44 44 44 44 44 44 44 44 44 44 44 44 44 44 44 44 44 44 44 44 44 44 44 44 44 44 44 44 44 44 44 44 44 44 44 44 44 44 44 44 44 44 44 44 44 44 44 44 44 44 44 44 44 44 44 44 44 44 44 44 44 44 44 44 44 44 44 44 44 44 44 44 44 44 44 44 44 44 
44 44 44 44 44 44 44 44 44 44 44 44 44 44 44 44 44 44 44 44 44 44 44 44 44 44 44 44 44 44 44 44 44 44 44 44 44 44 44 44 44 44 44 44 44 44 44 44 44 44 44 44 44 44 44 44 44 44 44 44 44 44 44 44 44 44 44 44 44 44 44 44 44 44 44 44 44 44 44 44 44 44 44 44 44 44 44 44 44 44 44 44 44 44 44 44 44 44 44 44 
44 44 44 44 44 44 44 44 44 44 44 44 44 44 44 44 44 44 44 44 44 44 44 44 44 44 44 44 44 44 44 44 44 44 44 44 44 44 44 44 44 44 44 44 44 44 44 44 44 44 44 44 44 44 44 44 44 44 44 44 44 44 44 44 44 44 44 44 44 44 44 44 44 44 44 44 44 44 44 44 44 44 44 44 44 44 44 44 44 44 44 44 44 44 44 44 44 44 44 44 
44 44 44 44 44 44 44 44 44 44 44 44 44 44 44 44 44 44 44 44 44 44 44 44 44 44 44 44 44 44 44 44 44 44 44 44 44 44 44 44 44 44 44 44 44 44 44 44 44 44 44 44 44 44 44 44 44 44 44 44 44 44 44 44 44 44 44 44 44 44 44 44 44 44 44 44 44 44 44 44 44 44 44 44 44 44 44 44 44 44 44 44 44 44 44 44 44 44 44 44 
44 44 44 44 44 44 44 44 44 44 44 44 44 44 44 44 44 44 44 44 44 44 44 44 44 44 44 44 44 44 44 44 44 44 44 44 44 44 44 44 44 44 44 44 44 44 44 44 44 44 44 44 44 44 44 44 44 44 44 44 44 44 44 44 44 44 44 44 44 44 44 44 44 44 44 44 44 44 44 44 44 44 44 44 44 44 44 44 44 44 44 44 44 44 44 44 44 44 44 44 
44 44 44 44 44 44 44 44 44 44 44 44 44 44 44 44 44 44 44 44 44 44 44 44 44 44 44 44 44 44 44 44 44 44 44 44 44 44 44 44 44 44 44 44 44 44 44 44 44 44 44 44 44 44 44 44 44 44 44 44 44 44 44 44 44 44 44 44 44 44 44 44 44 44 44 44 44 44 44 44 44 44 44 44 44 44 44 44 44 44 44 44 44 44 44 44 44 44 44 44 
44 44 44 44 44 44 44 44 44 44 44 44 44 44 44 44 44 44 44 44 44 44 44 44 44 44 44 44 44 44 44 44 44 44 44 44 44 44 44 44 44 44 44 44 44 44 44 44 44 44 44 44 44 44 44 44 44 44 44 44 44 44 44 44 44 44 44 44 44 44 44 44 44 44 44 44 44 44 44 44 44 44 44 44 44 44 44 44 44 44 44 44 44 44 44 44 44 44 44 44 
44 44 44 44 44 44 44 44 44 44 44 44 44 44 44 44 44 44 44 44 44 44 44 44 44 44 44 44 44 44 44 44 44 44 44 44 44 44 44 44 44 44 44 44 44 44 44 44 44 44 44 44 44 44 44 44 44 44 44 44 44 44 44 44 44 44 44 44 44 44 44 44 44 44 44 44 44 44 44 44 44 44 44 44 44 44 44 44 44 44 44 44 44 44 44 44 44 44 44 44 
44 44 44 44 44 44 44 44 44 44 44 44 44 44 44 44 44 44 44 44 44 44 44 44 44 44 44 44 44 44 44 44 44 44 44 44 44 44 44 44 44 44 44 44 44 44 44 44 44 44 44 44 44 44 44 44 44 44 44 44 44 44 44 44 44 44 44 44 44 44 44 44 44 44 44 44 44 44 44 44 44 44 44 44 44 44 44 44 44 44 44 44 44 44 44 44 44 44 44 44 
